#23456789012345678901234567890
..............................
..............................
..............................
..............................
..............................
..............................
..............................
.........b.........g..........
.....000000000.....r.P...r...0
000000000000000000000000000000


